11111111
100E1C01
100011P1
11111111