111111111
111111P11
1E1111111
111111C11
111111111