000000000
011111110
00111M110
0111P0000
000110000
000011000
0111E1100
011111110
000000000