000000000
011111110
00111M110
0P1111000
000110000
000011000
0111C1100
0E1111110
000000000