000000000
011111110
00111M110
0P1111000
000110000
000011000
0011C1100
0E0111110
000000000