111111111
100C00001
10101M001
1P1001001
100110001
100001001
1100C1101
1E1000011
111111111