000000000
01C111110
00111M110
0P1110000
000110000
000011000
0E1111100
011111110
000000000